RRRRRRRRRR
_RRRRGGGG_
_RRRRGGGG_
__BBBBBB__
___GGGG___
____BB_____